DEPrimeDualBroncos Akbronco Prime Blueprint 	Lith S2 Common
Lith S3 Common
Meso S3 Common 	PrimeBucks‍15
DEPrimeDualBroncos Akbronco Prime Link 	Lith N1 Uncommon
Lith S5 Uncommon
Axi S1 Uncommon 	PrimeBucks‍45
PrimeAkstiletto Akstiletto Prime Blueprint 	Lith A1 Rare
Neo A1 Rare 	PrimeBucks‍100
PrimeAkstiletto Akstiletto Prime Barrel 	Axi A1 Uncommon 	PrimeBucks‍45
PrimeAkstiletto Akstiletto Prime Receiver 	Axi K1 Uncommon
Axi T1 Uncommon 	PrimeBucks‍45
PrimeAkstiletto Akstiletto Prime Link 	Axi N1 Uncommon 	PrimeBucks‍45
DEPrimeAnkyros Ankyros Prime Blueprint 	Prime Vault 	PrimeBucks‍15
DEPrimeAnkyros Ankyros Prime Blade 	Prime Vault 	PrimeBucks‍100
DEPrimeAnkyros Ankyros Prime Gauntlet 	Prime Vault 	PrimeBucks‍15
AshPrime Ash Prime Blueprint 	Lith S3 Uncommon
Meso C1 Uncommon
Meso S3 Uncommon 	PrimeBucks‍45
AshPrime Ash Prime Chassis 	Meso V2 Common
Neo N4 Common 	PrimeBucks‍15
AshPrime Ash Prime Neuroptics 	Meso N2 Uncommon
Neo N3 Uncommon
Neo V4 Uncommon
Axi N2 Uncommon 	PrimeBucks‍45
AshPrime Ash Prime Systems 	Axi N1 Rare 	PrimeBucks‍100
PrimeBo Bo Prime Blueprint 	Prime Vault 	PrimeBucks‍15
PrimeBo Bo Prime Handle 	Prime Vault 	PrimeBucks‍45
PrimeBo Bo Prime Ornament 	Prime Vault 	PrimeBucks‍15
FixedPrimeBoar Boar Prime Blueprint 	Neo D1 Common 	PrimeBucks‍15
FixedPrimeBoar Boar Prime Barrel 	Axi V2 Uncommon 	PrimeBucks‍45
FixedPrimeBoar Boar Prime Receiver 	Lith M1 Common 	PrimeBucks‍15
FixedPrimeBoar Boar Prime Stock 	Meso B1 Rare 	PrimeBucks‍100
DEPrimeBoltor Boltor Prime Blueprint 	Prime Vault 	PrimeBucks‍100
DEPrimeBoltor Boltor Prime Barrel 	Prime Vault 	PrimeBucks‍15
DEPrimeBoltor Boltor Prime Receiver 	Prime Vault 	PrimeBucks‍45
DEPrimeBoltor Boltor Prime Stock 	Prime Vault 	PrimeBucks‍15
PrimeBraton Braton Prime Blueprint 	Meso V1 Uncommon
Axi N1 Common 	PrimeBucks‍25
PrimeBraton Braton Prime Barrel 	Lith A1 Common
Neo A1 Common 	PrimeBucks‍15
PrimeBraton Braton Prime Receiver 	Axi V2 Uncommon
Axi V3 Uncommon
Axi V5 Uncommon 	PrimeBucks‍45
PrimeBraton Braton Prime Stock 	Meso N1 Common
Neo N4 Common
Neo V2 Common
Axi A1 Common 	PrimeBucks‍15
PrimeBronco Bronco Prime Blueprint 	Lith N1 Common
Lith S1 Common
Meso C2 Common
Meso N2 Common
Meso S2 Common
Axi N2 Common
Axi S1 Common 	PrimeBucks‍15
PrimeBronco Bronco Prime Barrel 	Neo V1 Uncommon
Axi N3 Uncommon 	PrimeBucks‍45
PrimeBronco Bronco Prime Receiver 	Meso F1 Common
Neo V4 Common
Axi S1 Common 	PrimeBucks‍15
PrimeBurston Burston Prime Blueprint 	Meso V1 Common 	PrimeBucks‍15
PrimeBurston Burston Prime Barrel 	Lith F2 Uncommon
Axi T1 Uncommon 	PrimeBucks‍45
PrimeBurston Burston Prime Receiver 	Lith S5 Common
Neo S3 Common 	PrimeBucks‍15
PrimeBurston Burston Prime Stock 	Lith K1 Common
Lith V1 Common
Neo S2 Common 	PrimeBucks‍15
PrimeCarrier Carrier Prime Blueprint 	Meso V1 Common
Meso V3 Common
Neo S3 Common 	PrimeBucks‍15
PrimeCarrier Carrier Prime Carapace 	Lith S5 Common
Neo S1 Common
Axi N2 Common 	PrimeBucks‍15
PrimeCarrier Carrier Prime Cerebrum 	Lith C1 Rare
Meso C1 Rare
Meso C2 Rare 	PrimeBucks‍100
PrimeCarrier Carrier Prime Systems 	Lith S2 Common
Lith S3 Common
Neo A1 Common
Neo V3 Common
Axi V1 Common 	PrimeBucks‍15
SwordPrime Dakra Prime Blueprint 	Lith M1 Uncommon 	PrimeBucks‍45
SwordPrime Dakra Prime Blade 	Neo D1 Rare 	PrimeBucks‍100
SwordPrime Dakra Prime Handle 	Meso B1 Common 	PrimeBucks‍15
DualKamasPrime Dual Kamas Prime Blueprint 	Neo V1 Common
Axi N3 Common
Axi V1 Common
Axi V5 Common 	PrimeBucks‍15
DualKamasPrime Dual Kamas Prime Blade 	Meso D1 Rare 	PrimeBucks‍100
DualKamasPrime Dual Kamas Prime Handle 	Meso F1 Uncommon
Meso N1 Uncommon
Axi A1 Uncommon 	PrimeBucks‍45
EmberPrime Ember Prime Blueprint 	Prime Vault 	PrimeBucks‍100
EmberPrime Ember Prime Chassis 	Prime Vault 	PrimeBucks‍15
EmberPrime Ember Prime Neuroptics 	Prime Vault 	PrimeBucks‍15
EmberPrime Ember Prime Systems 	Prime Vault 	PrimeBucks‍45
PrimeFang Fang Prime Blueprint 	Lith K1 Common
Lith V2 Common
Meso N1 Common
Neo N2 Common 	PrimeBucks‍15
PrimeFang Fang Prime Blade 	Lith C1 Common
Lith F1 Common
Lith N1 Common
Lith S5 Common
Axi N1 Common 	PrimeBucks‍15
PrimeFang Fang Prime Handle 	Lith F2 Uncommon
Meso N1 Common
Meso N2 Common
Neo N3 Uncommon
Neo V2 Common 	PrimeBucks‍25
PrimeFragor Fragor Prime Blueprint 	Lith F1 Rare
Meso F1 Rare 	PrimeBucks‍100
PrimeFragor Fragor Prime Handle 	Lith V1 Rare 	PrimeBucks‍100
PrimeFragor Fragor Prime Head 	Axi A1 Common 	PrimeBucks‍15
FrostPrimecropped Frost Prime Blueprint 	Prime Vault 	PrimeBucks‍100
FrostPrimecropped Frost Prime Chassis 	Prime Vault 	PrimeBucks‍15
FrostPrimecropped Frost Prime Neuroptics 	Prime Vault 	PrimeBucks‍15
FrostPrimecropped Frost Prime Systems 	Prime Vault 	PrimeBucks‍45
PrimeGalatine342 Galatine Prime Blueprint 	Axi G1 Rare 	PrimeBucks‍100
PrimeGalatine342 Galatine Prime Blade 	Meso C2 Common
Meso S2 Common
Neo V2 Common
Neo V3 Common 	PrimeBucks‍15
PrimeGalatine342 Galatine Prime Handle 	Lith S5 Uncommon
Neo V2 Uncommon 	PrimeBucks‍45
PrimeGlaive Glaive Prime Blueprint 	Prime Vault 	PrimeBucks‍100
PrimeGlaive Glaive Prime Blade 	Prime Vault 	PrimeBucks‍45
PrimeGlaive Glaive Prime Disc 	Prime Vault 	PrimeBucks‍45
PrimeHikou Hikou Prime Blueprint 	Lith S1 Common
Meso N2 Common 	PrimeBucks‍15
PrimeHikou Hikou Prime Pouch 	Axi K1 Common
Axi V2 Common 	PrimeBucks‍15
PrimeHikou Hikou Prime Stars 	Lith F2 Common
Neo N1 Common 	PrimeBucks‍15
KavasaPrimeCollar Kavasa Prime Collar Blueprint 	Neo N1 Uncommon
Axi G1 Uncommon 	PrimeBucks‍45
KavasaPrimeCollar Kavasa Prime Collar Band 	Lith C1 Uncommon
Lith S2 Uncommon
Meso V3 Uncommon 	PrimeBucks‍45
KavasaPrimeCollar Kavasa Prime Collar Buckle 	Lith K1 Rare
Axi K1 Rare 	PrimeBucks‍100
DELatronPrime Latron Prime Blueprint 	Prime Vault 	PrimeBucks‍15
DELatronPrime Latron Prime Barrel 	Prime Vault 	PrimeBucks‍15
DELatronPrime Latron Prime Receiver 	Prime Vault 	PrimeBucks‍15
DELatronPrime Latron Prime Stock 	Prime Vault 	PrimeBucks‍15
PrimeLex Lex Prime Blueprint 	Lith S4 Common
Meso D1 Common
Neo N2 Common 	PrimeBucks‍15
PrimeLex Lex Prime Barrel 	Lith V2 Common
Neo N3 Common
Neo S1 Common
Axi K1 Common 	PrimeBucks‍15
PrimeLex Lex Prime Receiver 	Lith M1 Common
Axi C1 Common
Axi N2 Common 	PrimeBucks‍15
LokiPrime Loki Prime Blueprint 	Prime Vault 	PrimeBucks‍15
LokiPrime Loki Prime Chassis 	Prime Vault 	PrimeBucks‍45
LokiPrime Loki Prime Neuroptics 	Prime Vault 	PrimeBucks‍15
LokiPrime Loki Prime Systems 	Prime Vault 	PrimeBucks‍100
MagPrimecropped Mag Prime Blueprint 	Lith M1 Rare 	PrimeBucks‍100
MagPrimecropped Mag Prime Chassis 	Meso B1 Uncommon 	PrimeBucks‍45
MagPrimecropped Mag Prime Neuroptics 	Axi V2 Common 	PrimeBucks‍15
MagPrimecropped Mag Prime Systems 	Neo D1 Common 	PrimeBucks‍15
NekrosPrime342 Nekros Prime Blueprint 	Axi N3 Rare 	PrimeBucks‍100
NekrosPrime342 Nekros Prime Chassis 	Lith N1 Common
Meso S3 Common
Axi G1 Common 	PrimeBucks‍15
NekrosPrime342 Nekros Prime Neuroptics 	Meso F1 Uncommon 	PrimeBucks‍45
NekrosPrime342 Nekros Prime Systems 	Neo N3 Rare 	PrimeBucks‍100
PrimeNikana Nikana Prime Blueprint 	Axi A1 Rare 	PrimeBucks‍100
PrimeNikana Nikana Prime Blade 	Meso V2 Rare
Neo N4 Rare 	PrimeBucks‍100
PrimeNikana Nikana Prime Hilt 	Axi N2 Rare 	PrimeBucks‍100
NovaPrime Nova Prime Blueprint 	Neo N2 Uncommon 	PrimeBucks‍45
NovaPrime Nova Prime Chassis 	Lith N1 Rare
Neo V1 Rare 	PrimeBucks‍100
NovaPrime Nova Prime Neuroptics 	Lith C1 Common
Meso C1 Common 	PrimeBucks‍15
NovaPrime Nova Prime Systems 	Lith C1 Common
Meso S1 Common
Neo S2 Common 	PrimeBucks‍15
NyxPrime Nyx Prime Blueprint 	Lith S2 Common
Neo V1 Common 	PrimeBucks‍15
NyxPrime Nyx Prime Chassis 	Neo N1 Rare 	PrimeBucks‍100
NyxPrime Nyx Prime Neuroptics 	Meso N1 Rare 	PrimeBucks‍100
NyxPrime Nyx Prime Systems 	Neo S2 Uncommon 	PrimeBucks‍45
ArchwingSuitPrime Odonata Prime Blueprint 	Lith F1 Uncommon
Meso C2 Uncommon
Meso S1 Uncommon 	PrimeBucks‍45
ArchwingSuitPrime Odonata Prime Harness 	Lith K1 Common
Axi K1 Common
Axi T1 Common
Axi V4 Common 	PrimeBucks‍15
ArchwingSuitPrime Odonata Prime Systems 	Lith F2 Common
Neo N3 Common
Axi V1 Common 	PrimeBucks‍15
ArchwingSuitPrime Odonata Prime Wings 	Axi N1 Uncommon 	PrimeBucks‍45
PrimePolearm Orthos Prime Blueprint 	Meso B1 Uncommon
Axi C1 Uncommon
Axi V3 Uncommon 	PrimeBucks‍45
PrimePolearm Orthos Prime Blade 	Meso D1 Uncommon 	PrimeBucks‍45
PrimePolearm Orthos Prime Handle 	Meso B1 Common
Meso D1 Common 	PrimeBucks‍15
PrimeBowM Paris Prime Blueprint 	Lith F1 Common
Lith S4 Common
Meso S1 Common
Meso V2 Common
Axi G1 Common
Axi V4 Common 	PrimeBucks‍15
PrimeBowM Paris Prime Grip 	Lith S1 Uncommon
Meso S2 Uncommon 	PrimeBucks‍45
PrimeBowM Paris Prime Upper Limb 	Lith F2 Common
Lith V1 Common
Lith V2 Uncommon
Meso S1 Uncommon
Neo S2 Uncommon
Axi N3 Common 	PrimeBucks‍25
PrimeBowM Paris Prime Lower Limb 	Lith V1 Common
Lith V2 Common
Meso F1 Common
Neo S2 Common 	PrimeBucks‍15
PrimeBowM Paris Prime String 	Lith S1 Common
Lith S3 Common
Meso S2 Common
Neo N3 Common
Neo N4 Common
Neo V3 Common 	PrimeBucks‍15
ReaperPrime Reaper Prime Blueprint 	Prime Vault 	PrimeBucks‍15
ReaperPrime Reaper Prime Blade 	Prime Vault 	PrimeBucks‍45
ReaperPrime Reaper Prime Handle 	Prime Vault 	PrimeBucks‍15
DERhinoPrime Rhino Prime Blueprint 	Prime Vault 	PrimeBucks‍100
DERhinoPrime Rhino Prime Chassis 	Prime Vault 	PrimeBucks‍100
DERhinoPrime Rhino Prime Neuroptics 	Prime Vault 	PrimeBucks‍45
DERhinoPrime Rhino Prime Systems 	Prime Vault 	PrimeBucks‍15
SarynPrime Saryn Prime Blueprint 	Lith S4 Rare
Neo S1 Rare 	PrimeBucks‍100
SarynPrime Saryn Prime Chassis 	Meso S2 Rare
Neo S2 Rare 	PrimeBucks‍100
SarynPrime Saryn Prime Neuroptics 	Lith A1 Uncommon
Neo V4 Uncommon 	PrimeBucks‍45
SarynPrime Saryn Prime Systems 	Meso C1 Common
Meso F1 Common
Axi G1 Common
Axi T1 Common 	PrimeBucks‍15
PrimeScindo Scindo Prime Blueprint 	Lith F1 Uncommon 	PrimeBucks‍45
PrimeScindo Scindo Prime Blade 	Axi S1 Rare 	PrimeBucks‍100
PrimeScindo Scindo Prime Handle 	Meso C1 Uncommon 	PrimeBucks‍45
DESicarus Prime Sicarus Prime Blueprint 	Prime Vault 	PrimeBucks‍15
DESicarus Prime Sicarus Prime Barrel 	Prime Vault 	PrimeBucks‍15
DESicarus Prime Sicarus Prime Receiver 	Prime Vault 	PrimeBucks‍100
PrimeSoma Soma Prime Blueprint 	Lith M1 Uncommon
Neo S1 Common 	PrimeBucks‍15
PrimeSoma Soma Prime Stock 	Lith S2 Rare
Meso S1 Rare 	PrimeBucks‍100
PrimeSoma Soma Prime Receiver 	Lith S3 Uncommon
Neo N1 Uncommon 	PrimeBucks‍45
PrimeSoma Soma Prime Barrel 	Neo S3 Common 	PrimeBucks‍15
PrimeLiDagger Spira Prime Blueprint 	Meso V1 Common
Meso V3 Common 	PrimeBucks‍15
PrimeLiDagger Spira Prime Blade 	Lith S5 Rare
Neo S3 Rare 	PrimeBucks‍100
PrimeLiDagger Spira Prime Pouch 	Lith S1 Rare
Lith S3 Rare
Meso S3 Rare 	PrimeBucks‍100
PrimeTigris342 Tigris Prime Blueprint 	Axi T1 Rare 	PrimeBucks‍100
PrimeTigris342 Tigris Prime Stock 	Meso S1 Common
Neo V4 Common 	PrimeBucks‍15
PrimeTigris342 Tigris Prime Receiver 	Neo V3 Uncommon
Axi V5 Uncommon 	PrimeBucks‍45
PrimeTigris342 Tigris Prime Barrel 	Lith K1 Uncommon 	PrimeBucks‍45
TrinityPrime Trinity Prime Blueprint 	Lith K1 Uncommon
Axi S1 Uncommon 	PrimeBucks‍45
TrinityPrime Trinity Prime Chassis 	Lith S4 Uncommon
Neo S1 Uncommon 	PrimeBucks‍45
TrinityPrime Trinity Prime Neuroptics 	Neo D1 Uncommon
Axi C1 Common
Axi V3 Common 	PrimeBucks‍25
TrinityPrime Trinity Prime Systems 	Axi A1 Common
Axi V2 Common
Axi V3 Common
Axi V4 Common 	PrimeBucks‍15
PrimeVasto Vasto Prime Blueprint 	Neo S3 Uncommon 	PrimeBucks‍45
PrimeVasto Vasto Prime Barrel 	Neo D1 Common
Neo N2 Common
Axi V3 Common 	PrimeBucks‍15
PrimeVasto Vasto Prime Receiver 	Lith A1 Common
Meso V2 Common 	PrimeBucks‍15
VaubanPrime Vauban Prime Blueprint 	Lith F2 Rare
Neo V2 Rare 	PrimeBucks‍100
VaubanPrime Vauban Prime Chassis 	Axi V1 Rare 	PrimeBucks‍100
VaubanPrime Vauban Prime Neuroptics 	Meso N2 Rare
Neo V3 Rare 	PrimeBucks‍100
VaubanPrime Vauban Prime Systems 	Lith V2 Rare
Neo N2 Rare 	PrimeBucks‍100
VectisPrime Vectis Prime Blueprint 	Lith A1 Uncommon
Neo A1 Uncommon 	PrimeBucks‍45
VectisPrime Vectis Prime Barrel 	Neo N1 Common
Axi C1 Common
Axi T1 Common 	PrimeBucks‍15
VectisPrime Vectis Prime Receiver 	Meso V1 Rare 	PrimeBucks‍100
VectisPrime Vectis Prime Stock 	Axi V2 Rare
Axi V3 Rare
Axi V4 Rare 	PrimeBucks‍100
VoltPrime Volt Prime Blueprint 	Neo V1 Uncommon
Axi N3 Uncommon 	PrimeBucks‍45
VoltPrime Volt Prime Chassis 	Meso V2 Uncommon
Meso V3 Uncommon 	PrimeBucks‍45
VoltPrime Volt Prime Neuroptics 	Axi V1 Uncommon 	PrimeBucks‍45
VoltPrime Volt Prime Systems 	Lith V1 Uncommon 	PrimeBucks‍45
WyrmPrime Wyrm Prime Blueprint 	Prime Vault 	PrimeBucks‍15
WyrmPrime Wyrm Prime Carapace 	Prime Vault 	PrimeBucks‍15
WyrmPrime Wyrm Prime Cerebrum 	Prime Vault 	PrimeBucks‍15
WyrmPrime Wyrm Prime Systems 	Prime Vault 	PrimeBucks‍45 